16 16
╔═════╦═════╦═╦╗
║█████╚═══╗█║█╠╣
║█████████╚═╩═╬╣
║██╔╦══╗██╔╗██╠╣
║██╠╬═╗║██║╚╦╦╬╣
║██╠╣█║║██║╔╩╩╬╣
║██╠╝█║║██╚╝██╠╣
║╔╗║██║║██████╠╣
╚╝╚╬══╝║██████╠╣
███╚╗██║██████╠╣
███╔╝██║██████╠╣
███╚╗██║█████╔╬╣
╔═╦═╩══╝████╔╬╬╝
╠═╣█╔═══════╩╩╝█
║█╠═╩═════════╦╗
╚═╩═══════════╩╝

12

13 15
3 14
12 15
0 12
3 3
6 8
11 2
14 0
10 6
12 5
12 13
15 14

LEFT